37,0,0 37,1,0 37,2,0 37,3,0 37,0,0 37,1,0 37,2,0 37,3,0 37,0,0 37,1,0 37,2,0 37,3,0
37,0,1 37,1,1 37,2,1 37,3,1 37,0,1 37,1,1 37,2,1 37,3,1 37,0,1 37,1,1 37,2,1 37,3,1
37,0,2 37,1,2 37,2,2 37,3,2 37,0,2 37,1,2 37,2,2 37,3,2 37,0,2 37,1,2 37,2,2 37,3,2
37,0,3 37,1,3 37,2,3 37,3,3 37,0,3 37,1,3 37,2,3 37,3,3 37,0,3 37,1,3 37,2,3 37,3,3
37,0,0 37,1,0 37,2,0 37,3,0 37,0,0 37,1,0 37,2,0 37,3,0 37,0,0 37,1,0 37,2,0 37,3,0
37,0,1 37,1,1 37,2,1 37,3,1 37,0,1 37,1,1 37,2,1 37,3,1 37,0,1 37,1,1 37,2,1 37,3,1
37,0,2 37,1,2 37,2,2 37,3,2 37,0,2 37,1,2 37,2,2 37,3,2 37,0,2 37,1,2 37,2,2 37,3,2
37,0,3 37,1,3 37,2,3 37,3,3 37,0,3 37,1,3 37,2,3 37,3,3 37,0,3 37,1,3 37,2,3 37,3,3
