1,4,3 1,0,5 1,5,3 1,0,5 1,0,5 1,5,3 1,0,5 1,1,5 34,2,0 34,3,0 34,2,1 34,3,1
1,4,3 1,4,3 1,5,3 1,0,5 1,1,5 1,4,3 34,2,0 34,3,0 34,2,1 34,3,1 34,2,2 34,3,2
1,0,5 1,0,5 1,5,3 1,5,3 34,2,0 34,3,0 34,2,1 34,3,1 34,2,2 34,3,2 34,2,3 34,3,3
1,0,5 1,0,5 34,2,0 34,3,0 34,2,1 34,3,1 34,2,2 34,3,2 34,2,3 34,3,3 1,0,5 1,1,5
34,2,0 34,3,0 34,2,1 34,3,1 34,2,2 34,3,2 34,2,3 34,3,3 1,1,5 1,0,5 1,1,5 1,1,5
34,2,1 34,3,1 34,2,2 34,3,2 34,2,3 34,3,3 1,4,3 1,5,3 1,0,5 1,1,5 1,5,3 1,4,3
34,2,2 34,3,2 34,2,3 34,3,3 1,1,5 1,5,3 1,1,5 1,0,5 1,5,3 1,1,5 1,1,5 1,5,3
34,2,3 34,3,3 1,1,5 1,4,3 1,0,5 1,4,3 1,0,5 1,4,3 1,0,5 1,5,3 1,0,5 1,0,5
hard = eggeric2
