1,5,3 1,1,5 1,1,5 1,0,5 1,1,5 1,0,5 1,0,5 1,0,5 1,0,5 1,5,3 1,4,3 1,0,5
1,4,3 1,0,5 1,4,3 1,0,5 1,4,3 1,1,5 1,5,3 1,1,5 1,4,3 1,4,3 1,4,3 1,1,5
1,1,5 1,5,3 1,1,5 1,1,5 1,4,3 1,4,3 1,0,5 1,1,5 1,4,3 1,0,5 1,5,3 1,5,3
1,5,3 1,1,5 1,0,5 1,4,3 1,0,5 1,1,5 1,0,5 1,0,5 1,4,3 1,5,3 1,5,3 1,1,5
1,5,3 1,5,3 1,5,3 1,1,5 1,0,5 1,0,5 1,1,5 1,0,5 1,4,3 1,0,5 1,4,3 1,4,3
1,1,5 1,1,5 1,0,5 1,0,5 1,5,3 1,1,5 1,4,3 1,1,5 1,1,5 1,1,5 1,0,5 1,4,3
1,1,5 1,5,3 1,4,3 1,1,5 1,5,3 1,1,5 1,1,5 1,1,5 1,5,3 1,4,3 1,0,5 1,4,3
1,5,3 1,1,5 1,5,3 1,4,3 1,5,3 1,5,3 1,1,5 1,0,5 1,4,3 1,4,3 1,0,5 1,5,3
hard = eggeric3
