1,0,5 1,0,5 1,4,3 1,1,5 3,0,0 3,1,0 3,2,0 3,3,0 1,1,5 1,0,5 1,5,3 1,0,5
1,0,5 1,1,5 1,0,5 1,5,3 3,0,1 3,1,1 3,2,1 3,3,1 1,5,3 1,0,5 1,0,5 1,4,3
1,0,5 2,10,0 2,11,0 1,5,3 1,0,5 3,6,0 3,7,0 1,5,3 1,0,5 1,5,3 1,0,5 1,5,3
1,5,3 2,10,1 2,11,1 1,1,5 1,5,3 3,6,1 3,7,1 1,5,3 1,4,3 1,4,3 1,4,3 1,5,3
1,0,5 1,5,3 1,0,5 1,5,3 1,0,5 2,8,2 2,9,2 1,1,5 1,1,5 2,8,0 2,9,0 1,0,5
1,0,5 3,4,0 3,5,0 3,6,0 3,7,0 2,8,3 2,9,3 1,4,3 1,1,5 2,8,1 2,9,1 1,0,5
1,1,5 3,4,1 3,5,1 3,6,1 3,7,1 1,1,5 1,5,3 1,0,5 1,0,5 1,5,3 1,4,3 1,4,3
1,5,3 1,4,3 1,5,3 1,4,3 1,0,5 1,1,5 1,0,5 1,5,3 1,4,3 1,4,3 1,0,5 2,2,0
hard = arena
script = fight
