13,2,3 13,3,3 13,3,2 13,2,3 13,2,2 13,3,2 13,2,2 13,3,2 13,2,2 13,3,3 13,3,3 13,2,2
13,2,2 13,3,3 13,3,3 13,3,2 13,2,2 13,3,3 13,2,2 13,3,2 13,2,2 13,2,2 13,2,3 13,2,2
13,3,3 13,3,3 13,3,3 13,3,2 13,2,2 13,2,2 13,3,2 13,3,2 13,2,2 13,2,2 13,3,2 13,3,2
13,3,3 13,3,3 13,3,3 13,2,2 13,2,2 13,3,3 13,3,2 13,3,2 13,2,2 13,2,3 13,3,3 13,2,2
13,3,3 13,2,3 13,3,3 13,3,2 13,3,3 13,2,3 13,2,2 13,3,3 13,2,3 13,3,2 13,2,3 13,3,2
13,2,3 13,3,2 13,2,3 13,3,2 13,3,2 13,3,2 13,3,3 13,2,2 13,3,3 13,3,3 13,3,2 13,2,2
13,2,2 13,3,3 13,3,2 13,3,3 13,3,2 13,2,3 13,2,3 13,2,3 13,3,3 13,2,2 13,3,3 13,3,3
13,3,3 13,3,3 13,2,3 13,2,2 13,2,3 13,3,2 13,3,3 13,3,2 13,2,2 13,2,2 13,2,3 13,2,2
script = beknight
